+++++++++++++++++++
+   ++ ++        ++
+ +       +++ +   +
+ + +  ++++   + + +
+     +++++++  +  +
+ +++      S +    
+            ++++++
+++++++++++++++++++