+++++++++++++++++++++++
+   +   ++ ++     +  ++
+ +   +       +++ + +++
+ + +  ++  ++++   + +++
+++ ++++++    +++ +  ++
+          ++  ++    ++
+++++ ++++++   +++++ ++
+     +S  +++++++  + ++
+ +++++++        +    +
+        ++      ++++++
+     +   +      ++++++
+    +++  +  ++  ++++++
+              + ++++++
+    ++   +++  + ++++++
+    +  + +      ++++++
+  +      + + +  ++++++
+         ++  +++++++++
+                ++++++
+                ++++++
+                ++++++
+++++++++++++++++++++++