+++++++++++++++++++++++
+   +   ++ ++     +  ++
+ +   +       +++ + +++
+ + +  ++  ++++   + +++
+++ ++++++    +++ +  ++
+          ++  ++    ++
+++++ ++++++   +++++ ++
+     +   +++++++  + ++
+ +++++++      S +    +
+                ++++++
+++++++++++++++++++++++